1111111111111111111111111111111111111111
1030040020300404000000000020420000400301
1002000040030030050000044340040000003001
1000404040030000000000043440040000400001
1040000400000000444000000040030204004401
1420300403300000434200200004000400020301
1004000000000000043400400000000200000041
1111111111111111111111110000011111111111
1000000300204300000404000000030000400001
1040400000030000000004200400003000003001
1000000000030040000040400400000000400001
1404400000000040000004004000040004004401
1403400060000034004000000004000000404401
1000300000000000400000003400000000400401
1111111111111111111111111111111000400411
1030040020300404000000000020420000400301
1002000040030030000000044340040000003001
1000404040030000000000043440040000400001
1040000400000004440000000400302040044001
1420300403300000434200200004000400020301
1034000000000000043400400000000200000041
1111111111111111111111111111111111111111