1111111111111111111111111111111111111111
1000000300704300000404000000030000400001
1045400000030000000004200400003000003001
1000000000030040000040400400000000400001
1404400000000040000004004000040004004401
1403400000000034004000000004000000404401
1000300000000000400000003400000000400401
1111111111111111111111111111111000400411
1030040020300404000000000020420000400301
1002000040030030000000044340040000003001
1000404040030000000000043440040000400001
1040000400000000444000000040030204004401
1420300403300000434200200004000400020301
1043000000000000043400400000000200000041
1000000001111111111111111111111111111111
1340000000004000200004000004000400000001
1340000000003400400000000400000040440061
1030040000000040000040330000200040440001
1000042004000000004000000404200000040001
1000300403004044000000000404200000030041
1020000300000300000000000400400004000401
1111111111111111111111111111111111111111