1111111111
1624304001
1004300001
1050000001
1111111111