1111111111111111111111111111111111111111
1030040020300404000006000020420000400301
1002000040030030000000044340040000003001
1000404040030000200000043440040000400001
1040000400000004440000000400302040044001
1420300403300000434200200004000400020301
1004000000000000043400400000000200000041
1111110000000011111111111111100000011111
1000000000000000000200000000000000400411
1030040020300404000000000020420000400301
1002000040030030002000044340040000003001
1000404040030000000000043440040000400001
1040000400005004440000000400302040044001
1420300403300000434200200004000400020301
1111111111111111111111111111111111111111